10 3
0000000000
0000100000
0000200000
0000200000
0000100000
0000800000
0000900000
0000900000
0000100000
0000111100
3 4 180
5
1 2 3 4 9
2
6 7
3
1 3 4