12
000006200000
000000100000
000000100000
000000100000
000000100000
000000200000
000000200000
000000200000
000000200000
000000200000
000000200000
000000200000
11 6 0
5
1 2 3 8 9
2
31 32
2
1 2