10
0000000000
0000000000
0000000000
0000110000
0002222000
0022002200
0220000270
0000000000
0000000000
0000000000
6 1 90
4
1 2 3 8
1
51
2
1 2