10
0000000000
0000000060
0000000120
0000001200
0000012000
0000120000
0001200000
0012000000
0120000000
0000000000
8 1 90
4
1 2 3 8
1
41
0
