10
0000000000
0010000000
0010000000
0010000000
0010000000
0010000000
0010000000
0010000000
0031111160
0000000000
1 2 180
4
1 2 3 8
1
31
2
1 3