10
0000000000
0000060000
0000020000
0000030000
0000020000
0000010000
0000020000
0000030000
0000010000
0000000000
8 5 0
2
1 8
1
21
0
