9
000000000
080000000
020000000
020000000
012222230
020000000
020000000
080000000
000000000
4 7 270
6
1 2 3 5 8 9
2
41 32
3
1 2 3