9
000000000
000000000
000000000
062232260
000020000
000020000
000010000
000000000
000000000
6 4 0
5
1 2 3 5 8
1
61
3
1 2 3